---@-@-------@---@-@---------@-------
-@-@-@-@-@@@-@-@@@-@@@@@-@@@@@@@-@@@-
-@-----@-@-----------@---@-----@---@-
-@-@-@@@@@@@-@-@-@@@@@-@@@@@@@-@-@-@@
-@-@-----@-@-@-@-----------@—----@---
-@-@@@@@-@-@@@-@@@@@-@@@@@@@-@@@@@-@@
-@---@-@---@---@-@-@-@-----@-@-----@-
-@-@@@-@-@@@@@-@-@-@-@-@@@@@@@-@-@-@-
-@-@-@-@-@-------@---@---------@-@---
-@@@-@-@@@@@-@@@@@@@@@-@-@-@@@@@-@-@-
-----@-@---@-----@-@-@-@-@-----@-@-@-
-@-@@@-@-@@@@@@@-@-@-@-@@@@@@@@@@@@@-
-@---@---------------@-@---@-----@-@-
@@-@@@@@@@@@-@@@@@@@-@-@-@@@-@@@-@-@-
---@---@-@-@---@-------------@-----@-
-@-@-@@@-@-@-@@@@@@@-@@@@@@@@@-@@@@@-
-@-------@-------@-----@-----------@-