-@-------------@-------@---@---------
-@@@-@@@@@-@@@-@-@@@-@@@@@-@@@@@-@-@-
-----@-@-----@-@---@---------@---@-@-
@@@@@@-@@@@@@@-@@@@@@@-@@@@@@@@@-@@@@
-------@---@-@---@-------@-----------
-@@@@@-@-@@@-@@@-@-@@@@@-@-@-@@@@@@@-
-----@---@---@-----@-@---@-@---@-@---
@@@@@@@@-@-@@@@@-@@@-@@@-@-@@@@@-@-@-
-----@-----@-@---@---@---@-----@---@--
-@@@@@@@-@@@-@-@@@@@-@-@@@-@-@@@-@-@@@
---@-------@-----@---@-----@---@-@---
-@@@-@-@-@@@@@@@-@-@@@-@@@@@-@@@@@@@@
-----@-@-@-@---@-@-@-@-@---@-@---@----
@@@@@@@@-@-@-@-@@@-@-@-@@@-@@@-@@@-@@
-----@-@-----@-------------@---@-@-@-
-@-@@@-@-@@@@@@@@@@@@@-@-@-@@@-@-@-@-@
-@-----------@-@---@---@-@-@-@---@---
@@-@-@@@-@@@@@-@-@-@@@@@-@-@-@-@-@@@-
---@---@-------@-@-----@-@-----@-----
-@-@-@-@-@-@@@@@-@-@@@-@@@@@@@@@@@-@-
-@-@-@-@-@-------@---@-@-----------@-